INDEX OF AUTHORS 197

Soundara Misra: Abhirama mani X C 2
Speroni: Canace XXVI C 2
Spontini: The Danaides XXIII B 8
Stace: Agave XXXI A 1
Stein: La Veuve joyeuse XXVIII A 2
Sue: Les Enfants naturals XVIII A 2
T
Tarbé: Monsieur de Morat XXV B 3
Tasso: Torrismond XVIII A 2
“ Jerusalem Delivered XIX G 1
Tchang-Koue—pin: The Tunic Sonfranted III' A 1
Tellez: Don Juan V B
Temi (Mme): Les Béillinnés XXXVI A 2
Theodecte: Gidipus , XVIII A 1
“ Lyncee XXIII B 3
Thenriet: La Maison des deux Barzeaux XXV C 4
Thomns: Francoise de Rimini XXV C 3
Tiercelin: Un voyage de noses XXV A 2
Tirso de Molina: Don Juan V B
Tolstoi: The Powers of Darkness XIII F
and XV A 1
“ Resurrection xx C
“ The Kreutzer Sonata XXV D 1
Torquet: Cent lignes émues XXXVI G
Trarieux: La Dette XIV B 1
Trissino: Sophonisbe XX B 3
Tristan l’ Hermite: Marianne XXXII A 1
V
Vacquérie: Proserpine XXV B 7
“ Jalousie XXXII C 5
Vallette: Le Vierge XXXIII B 8
Valnay: L’Esclase du devoir XXXII A 3
Van Velde (Mme.): Lena XXVI! B 4
Vauzelles (de): Alceste XXI A 1
Veber: Les Grands , XXXIII A 3
Vedanyatha Vatchespati: Tchitra Yadjgna. XXXI B 2
Verga: Chevalerie mstique XXII A 10
Verhaeren: Le Cloitre XXXIV A 2
Verlaine: Louise Leelercq XVII C 2
Verne; Le Tour du monde en 80 jours IX D l
" Les Enfants du capitaine Grant XXXV
Villemer: L’Absente XXVII B l
Villiers: Don Juan V B

 

